500px = 500px
airbnb = Airbnb
amazon = Amazon
angellist = Angellist
app-store = App-Store
artstation = Artstation
audible = Audible
bandcamp = Bandcamp
behance = Behance
blogger-b = Blogger
delicious = Delicious
digg = Digg
dribbble = Dribbble
dropbox = Dropbox
ello = Ello
facebook-f = Facebook
facebook-messenger = Facebook Messenger
flickr = Flickr
foursquare = Foursquare
github = Github
gitlab = Gitlab
google-drive= Google Drive
google-play= Google Play
google-plus-g = Google+
houzz = Houzz
instagram = Instagram
itunes-note = Itunes
kickstarter-k = Kickstarter
lastfm = ast.fm
linkedin-in= Linked In
medium-m = Medium
meetup = Meetup
mixcloud= Mix Cloud
mixer = Mixer
napster = Napster
pinterest-p = Pinterest
playstation = Playstation
reddit-alien = Reddit
scribd = Scribd
skype = Skype
slideshare= Slide Share
snapchat-ghost = Snapchat
soundcloud= Sound Cloud
spotify = Spotify
stack-overflow= Stack Overflow
steam-symbol = Steam
stumbleupon = Stumbleupon
telegram-plane = Telegram
trello = Trello
tripadvisor = TripAdvisor
tumblr = tumblr
twitch = Twitch
twitter = Twitter
uber = Uber
viadeo = Viadeo
viber = Viber
vimeo-v = Vimeo
vine = Vine
waze = Waze
wikipedia-w = Wikipedia
xbox = Xbox
xing = Xing
yammer = Yammer
youtube = Youtube